qtl_subset	qtl_ss	qtl_ss_index	qtl_perm
Alasoo_2018.macrophage_IFNg_tx	/gpfs/hpc/projects/eQTLCatalogue/qtlmap/eQTL_Catalogue_r3/pipeline_out/sumstats/Alasoo_2018.macrophage_IFNg_tx.nominal.sorted.tsv.gz	/gpfs/hpc/projects/eQTLCatalogue/qtlmap/eQTL_Catalogue_r3/pipeline_out/sumstats/Alasoo_2018.macrophage_IFNg_tx.nominal.sorted.tsv.gz.tbi	/gpfs/hpc/projects/eQTLCatalogue/qtlmap/eQTL_Catalogue_r3/pipeline_out/sumstats/Alasoo_2018.macrophage_IFNg_tx.permuted.txt.gz
Alasoo_2018.macrophage_IFNg+Salmonella_tx	/gpfs/hpc/projects/eQTLCatalogue/qtlmap/eQTL_Catalogue_r3/pipeline_out/sumstats/Alasoo_2018.macrophage_IFNg+Salmonella_tx.nominal.sorted.tsv.gz	/gpfs/hpc/projects/eQTLCatalogue/qtlmap/eQTL_Catalogue_r3/pipeline_out/sumstats/Alasoo_2018.macrophage_IFNg+Salmonella_tx.nominal.sorted.tsv.gz.tbi	/gpfs/hpc/projects/eQTLCatalogue/qtlmap/eQTL_Catalogue_r3/pipeline_out/sumstats/Alasoo_2018.macrophage_IFNg+Salmonella_tx.permuted.txt.gz
Alasoo_2018.macrophage_naive_tx	/gpfs/hpc/projects/eQTLCatalogue/qtlmap/eQTL_Catalogue_r3/pipeline_out/sumstats/Alasoo_2018.macrophage_naive_tx.nominal.sorted.tsv.gz	/gpfs/hpc/projects/eQTLCatalogue/qtlmap/eQTL_Catalogue_r3/pipeline_out/sumstats/Alasoo_2018.macrophage_naive_tx.nominal.sorted.tsv.gz.tbi	/gpfs/hpc/projects/eQTLCatalogue/qtlmap/eQTL_Catalogue_r3/pipeline_out/sumstats/Alasoo_2018.macrophage_naive_tx.permuted.txt.gz
Alasoo_2018.macrophage_Salmonella_tx	/gpfs/hpc/projects/eQTLCatalogue/qtlmap/eQTL_Catalogue_r3/pipeline_out/sumstats/Alasoo_2018.macrophage_Salmonella_tx.nominal.sorted.tsv.gz	/gpfs/hpc/projects/eQTLCatalogue/qtlmap/eQTL_Catalogue_r3/pipeline_out/sumstats/Alasoo_2018.macrophage_Salmonella_tx.nominal.sorted.tsv.gz.tbi	/gpfs/hpc/projects/eQTLCatalogue/qtlmap/eQTL_Catalogue_r3/pipeline_out/sumstats/Alasoo_2018.macrophage_Salmonella_tx.permuted.txt.gz
BLUEPRINT_PE.T-cell_tx	/gpfs/hpc/projects/eQTLCatalogue/qtlmap/eQTL_Catalogue_r3/pipeline_out/sumstats/BLUEPRINT_PE.T-cell_tx.nominal.sorted.tsv.gz	/gpfs/hpc/projects/eQTLCatalogue/qtlmap/eQTL_Catalogue_r3/pipeline_out/sumstats/BLUEPRINT_PE.T-cell_tx.nominal.sorted.tsv.gz.tbi	/gpfs/hpc/projects/eQTLCatalogue/qtlmap/eQTL_Catalogue_r3/pipeline_out/sumstats/BLUEPRINT_PE.T-cell_tx.permuted.txt.gz
BLUEPRINT_SE.monocyte_tx	/gpfs/hpc/projects/eQTLCatalogue/qtlmap/eQTL_Catalogue_r3/pipeline_out/sumstats/BLUEPRINT_SE.monocyte_tx.nominal.sorted.tsv.gz	/gpfs/hpc/projects/eQTLCatalogue/qtlmap/eQTL_Catalogue_r3/pipeline_out/sumstats/BLUEPRINT_SE.monocyte_tx.nominal.sorted.tsv.gz.tbi	/gpfs/hpc/projects/eQTLCatalogue/qtlmap/eQTL_Catalogue_r3/pipeline_out/sumstats/BLUEPRINT_SE.monocyte_tx.permuted.txt.gz
BLUEPRINT_SE.neutrophil_tx	/gpfs/hpc/projects/eQTLCatalogue/qtlmap/eQTL_Catalogue_r3/pipeline_out/sumstats/BLUEPRINT_SE.neutrophil_tx.nominal.sorted.tsv.gz	/gpfs/hpc/projects/eQTLCatalogue/qtlmap/eQTL_Catalogue_r3/pipeline_out/sumstats/BLUEPRINT_SE.neutrophil_tx.nominal.sorted.tsv.gz.tbi	/gpfs/hpc/projects/eQTLCatalogue/qtlmap/eQTL_Catalogue_r3/pipeline_out/sumstats/BLUEPRINT_SE.neutrophil_tx.permuted.txt.gz
BrainSeq.brain_tx	/gpfs/hpc/projects/eQTLCatalogue/qtlmap/eQTL_Catalogue_r3/pipeline_out/sumstats/BrainSeq.brain_tx.nominal.sorted.tsv.gz	/gpfs/hpc/projects/eQTLCatalogue/qtlmap/eQTL_Catalogue_r3/pipeline_out/sumstats/BrainSeq.brain_tx.nominal.sorted.tsv.gz.tbi	/gpfs/hpc/projects/eQTLCatalogue/qtlmap/eQTL_Catalogue_r3/pipeline_out/sumstats/BrainSeq.brain_tx.permuted.txt.gz
FUSION.adipose_naive_tx	/gpfs/hpc/projects/eQTLCatalogue/qtlmap/eQTL_Catalogue_r3/pipeline_out/sumstats/FUSION.adipose_naive_tx.nominal.sorted.tsv.gz	/gpfs/hpc/projects/eQTLCatalogue/qtlmap/eQTL_Catalogue_r3/pipeline_out/sumstats/FUSION.adipose_naive_tx.nominal.sorted.tsv.gz.tbi	/gpfs/hpc/projects/eQTLCatalogue/qtlmap/eQTL_Catalogue_r3/pipeline_out/sumstats/FUSION.adipose_naive_tx.permuted.txt.gz
FUSION.muscle_naive_tx	/gpfs/hpc/projects/eQTLCatalogue/qtlmap/eQTL_Catalogue_r3/pipeline_out/sumstats/FUSION.muscle_naive_tx.nominal.sorted.tsv.gz	/gpfs/hpc/projects/eQTLCatalogue/qtlmap/eQTL_Catalogue_r3/pipeline_out/sumstats/FUSION.muscle_naive_tx.nominal.sorted.tsv.gz.tbi	/gpfs/hpc/projects/eQTLCatalogue/qtlmap/eQTL_Catalogue_r3/pipeline_out/sumstats/FUSION.muscle_naive_tx.permuted.txt.gz
GENCORD.fibroblast_tx	/gpfs/hpc/projects/eQTLCatalogue/qtlmap/eQTL_Catalogue_r3/pipeline_out/sumstats/GENCORD.fibroblast_tx.nominal.sorted.tsv.gz	/gpfs/hpc/projects/eQTLCatalogue/qtlmap/eQTL_Catalogue_r3/pipeline_out/sumstats/GENCORD.fibroblast_tx.nominal.sorted.tsv.gz.tbi	/gpfs/hpc/projects/eQTLCatalogue/qtlmap/eQTL_Catalogue_r3/pipeline_out/sumstats/GENCORD.fibroblast_tx.permuted.txt.gz
GENCORD.LCL_tx	/gpfs/hpc/projects/eQTLCatalogue/qtlmap/eQTL_Catalogue_r3/pipeline_out/sumstats/GENCORD.LCL_tx.nominal.sorted.tsv.gz	/gpfs/hpc/projects/eQTLCatalogue/qtlmap/eQTL_Catalogue_r3/pipeline_out/sumstats/GENCORD.LCL_tx.nominal.sorted.tsv.gz.tbi	/gpfs/hpc/projects/eQTLCatalogue/qtlmap/eQTL_Catalogue_r3/pipeline_out/sumstats/GENCORD.LCL_tx.permuted.txt.gz
GENCORD.T-cell_tx	/gpfs/hpc/projects/eQTLCatalogue/qtlmap/eQTL_Catalogue_r3/pipeline_out/sumstats/GENCORD.T-cell_tx.nominal.sorted.tsv.gz	/gpfs/hpc/projects/eQTLCatalogue/qtlmap/eQTL_Catalogue_r3/pipeline_out/sumstats/GENCORD.T-cell_tx.nominal.sorted.tsv.gz.tbi	/gpfs/hpc/projects/eQTLCatalogue/qtlmap/eQTL_Catalogue_r3/pipeline_out/sumstats/GENCORD.T-cell_tx.permuted.txt.gz
GEUVADIS.LCL_tx	/gpfs/hpc/projects/eQTLCatalogue/qtlmap/eQTL_Catalogue_r3/pipeline_out/sumstats/GEUVADIS.LCL_tx.nominal.sorted.tsv.gz	/gpfs/hpc/projects/eQTLCatalogue/qtlmap/eQTL_Catalogue_r3/pipeline_out/sumstats/GEUVADIS.LCL_tx.nominal.sorted.tsv.gz.tbi	/gpfs/hpc/projects/eQTLCatalogue/qtlmap/eQTL_Catalogue_r3/pipeline_out/sumstats/GEUVADIS.LCL_tx.permuted.txt.gz
HipSci.iPSC_tx	/gpfs/hpc/projects/eQTLCatalogue/qtlmap/eQTL_Catalogue_r3/pipeline_out/sumstats/HipSci.iPSC_tx.nominal.sorted.tsv.gz	/gpfs/hpc/projects/eQTLCatalogue/qtlmap/eQTL_Catalogue_r3/pipeline_out/sumstats/HipSci.iPSC_tx.nominal.sorted.tsv.gz.tbi	/gpfs/hpc/projects/eQTLCatalogue/qtlmap/eQTL_Catalogue_r3/pipeline_out/sumstats/HipSci.iPSC_tx.permuted.txt.gz
Lepik_2017.blood_tx	/gpfs/hpc/projects/eQTLCatalogue/qtlmap/eQTL_Catalogue_r3/pipeline_out/sumstats/Lepik_2017.blood_tx.nominal.sorted.tsv.gz	/gpfs/hpc/projects/eQTLCatalogue/qtlmap/eQTL_Catalogue_r3/pipeline_out/sumstats/Lepik_2017.blood_tx.nominal.sorted.tsv.gz.tbi	/gpfs/hpc/projects/eQTLCatalogue/qtlmap/eQTL_Catalogue_r3/pipeline_out/sumstats/Lepik_2017.blood_tx.permuted.txt.gz
Nedelec_2016.macrophage_Listeria_tx	/gpfs/hpc/projects/eQTLCatalogue/qtlmap/eQTL_Catalogue_r3/pipeline_out/sumstats/Nedelec_2016.macrophage_Listeria_tx.nominal.sorted.tsv.gz	/gpfs/hpc/projects/eQTLCatalogue/qtlmap/eQTL_Catalogue_r3/pipeline_out/sumstats/Nedelec_2016.macrophage_Listeria_tx.nominal.sorted.tsv.gz.tbi	/gpfs/hpc/projects/eQTLCatalogue/qtlmap/eQTL_Catalogue_r3/pipeline_out/sumstats/Nedelec_2016.macrophage_Listeria_tx.permuted.txt.gz
Nedelec_2016.macrophage_naive_tx	/gpfs/hpc/projects/eQTLCatalogue/qtlmap/eQTL_Catalogue_r3/pipeline_out/sumstats/Nedelec_2016.macrophage_naive_tx.nominal.sorted.tsv.gz	/gpfs/hpc/projects/eQTLCatalogue/qtlmap/eQTL_Catalogue_r3/pipeline_out/sumstats/Nedelec_2016.macrophage_naive_tx.nominal.sorted.tsv.gz.tbi	/gpfs/hpc/projects/eQTLCatalogue/qtlmap/eQTL_Catalogue_r3/pipeline_out/sumstats/Nedelec_2016.macrophage_naive_tx.permuted.txt.gz
Nedelec_2016.macrophage_Salmonella_tx	/gpfs/hpc/projects/eQTLCatalogue/qtlmap/eQTL_Catalogue_r3/pipeline_out/sumstats/Nedelec_2016.macrophage_Salmonella_tx.nominal.sorted.tsv.gz	/gpfs/hpc/projects/eQTLCatalogue/qtlmap/eQTL_Catalogue_r3/pipeline_out/sumstats/Nedelec_2016.macrophage_Salmonella_tx.nominal.sorted.tsv.gz.tbi	/gpfs/hpc/projects/eQTLCatalogue/qtlmap/eQTL_Catalogue_r3/pipeline_out/sumstats/Nedelec_2016.macrophage_Salmonella_tx.permuted.txt.gz
Quach_2016.monocyte_IAV_tx	/gpfs/hpc/projects/eQTLCatalogue/qtlmap/eQTL_Catalogue_r3/pipeline_out/sumstats/Quach_2016.monocyte_IAV_tx.nominal.sorted.tsv.gz	/gpfs/hpc/projects/eQTLCatalogue/qtlmap/eQTL_Catalogue_r3/pipeline_out/sumstats/Quach_2016.monocyte_IAV_tx.nominal.sorted.tsv.gz.tbi	/gpfs/hpc/projects/eQTLCatalogue/qtlmap/eQTL_Catalogue_r3/pipeline_out/sumstats/Quach_2016.monocyte_IAV_tx.permuted.txt.gz
Quach_2016.monocyte_LPS_tx	/gpfs/hpc/projects/eQTLCatalogue/qtlmap/eQTL_Catalogue_r3/pipeline_out/sumstats/Quach_2016.monocyte_LPS_tx.nominal.sorted.tsv.gz	/gpfs/hpc/projects/eQTLCatalogue/qtlmap/eQTL_Catalogue_r3/pipeline_out/sumstats/Quach_2016.monocyte_LPS_tx.nominal.sorted.tsv.gz.tbi	/gpfs/hpc/projects/eQTLCatalogue/qtlmap/eQTL_Catalogue_r3/pipeline_out/sumstats/Quach_2016.monocyte_LPS_tx.permuted.txt.gz
Quach_2016.monocyte_naive_tx	/gpfs/hpc/projects/eQTLCatalogue/qtlmap/eQTL_Catalogue_r3/pipeline_out/sumstats/Quach_2016.monocyte_naive_tx.nominal.sorted.tsv.gz	/gpfs/hpc/projects/eQTLCatalogue/qtlmap/eQTL_Catalogue_r3/pipeline_out/sumstats/Quach_2016.monocyte_naive_tx.nominal.sorted.tsv.gz.tbi	/gpfs/hpc/projects/eQTLCatalogue/qtlmap/eQTL_Catalogue_r3/pipeline_out/sumstats/Quach_2016.monocyte_naive_tx.permuted.txt.gz
Quach_2016.monocyte_Pam3CSK4_tx	/gpfs/hpc/projects/eQTLCatalogue/qtlmap/eQTL_Catalogue_r3/pipeline_out/sumstats/Quach_2016.monocyte_Pam3CSK4_tx.nominal.sorted.tsv.gz	/gpfs/hpc/projects/eQTLCatalogue/qtlmap/eQTL_Catalogue_r3/pipeline_out/sumstats/Quach_2016.monocyte_Pam3CSK4_tx.nominal.sorted.tsv.gz.tbi	/gpfs/hpc/projects/eQTLCatalogue/qtlmap/eQTL_Catalogue_r3/pipeline_out/sumstats/Quach_2016.monocyte_Pam3CSK4_tx.permuted.txt.gz
Quach_2016.monocyte_R848_tx	/gpfs/hpc/projects/eQTLCatalogue/qtlmap/eQTL_Catalogue_r3/pipeline_out/sumstats/Quach_2016.monocyte_R848_tx.nominal.sorted.tsv.gz	/gpfs/hpc/projects/eQTLCatalogue/qtlmap/eQTL_Catalogue_r3/pipeline_out/sumstats/Quach_2016.monocyte_R848_tx.nominal.sorted.tsv.gz.tbi	/gpfs/hpc/projects/eQTLCatalogue/qtlmap/eQTL_Catalogue_r3/pipeline_out/sumstats/Quach_2016.monocyte_R848_tx.permuted.txt.gz
ROSMAP.brain_naive_tx	/gpfs/hpc/projects/eQTLCatalogue/qtlmap/eQTL_Catalogue_r3/pipeline_out/sumstats/ROSMAP.brain_naive_tx.nominal.sorted.tsv.gz	/gpfs/hpc/projects/eQTLCatalogue/qtlmap/eQTL_Catalogue_r3/pipeline_out/sumstats/ROSMAP.brain_naive_tx.nominal.sorted.tsv.gz.tbi	/gpfs/hpc/projects/eQTLCatalogue/qtlmap/eQTL_Catalogue_r3/pipeline_out/sumstats/ROSMAP.brain_naive_tx.permuted.txt.gz
Schmiedel_2018.B-cell_naive_tx	/gpfs/hpc/projects/eQTLCatalogue/qtlmap/eQTL_Catalogue_r3/pipeline_out/sumstats/Schmiedel_2018.B-cell_naive_tx.nominal.sorted.tsv.gz	/gpfs/hpc/projects/eQTLCatalogue/qtlmap/eQTL_Catalogue_r3/pipeline_out/sumstats/Schmiedel_2018.B-cell_naive_tx.nominal.sorted.tsv.gz.tbi	/gpfs/hpc/projects/eQTLCatalogue/qtlmap/eQTL_Catalogue_r3/pipeline_out/sumstats/Schmiedel_2018.B-cell_naive_tx.permuted.txt.gz
Schmiedel_2018.CD4_T-cell_anti-CD3-CD28_tx	/gpfs/hpc/projects/eQTLCatalogue/qtlmap/eQTL_Catalogue_r3/pipeline_out/sumstats/Schmiedel_2018.CD4_T-cell_anti-CD3-CD28_tx.nominal.sorted.tsv.gz	/gpfs/hpc/projects/eQTLCatalogue/qtlmap/eQTL_Catalogue_r3/pipeline_out/sumstats/Schmiedel_2018.CD4_T-cell_anti-CD3-CD28_tx.nominal.sorted.tsv.gz.tbi	/gpfs/hpc/projects/eQTLCatalogue/qtlmap/eQTL_Catalogue_r3/pipeline_out/sumstats/Schmiedel_2018.CD4_T-cell_anti-CD3-CD28_tx.permuted.txt.gz
Schmiedel_2018.CD4_T-cell_naive_tx	/gpfs/hpc/projects/eQTLCatalogue/qtlmap/eQTL_Catalogue_r3/pipeline_out/sumstats/Schmiedel_2018.CD4_T-cell_naive_tx.nominal.sorted.tsv.gz	/gpfs/hpc/projects/eQTLCatalogue/qtlmap/eQTL_Catalogue_r3/pipeline_out/sumstats/Schmiedel_2018.CD4_T-cell_naive_tx.nominal.sorted.tsv.gz.tbi	/gpfs/hpc/projects/eQTLCatalogue/qtlmap/eQTL_Catalogue_r3/pipeline_out/sumstats/Schmiedel_2018.CD4_T-cell_naive_tx.permuted.txt.gz
Schmiedel_2018.CD8_T-cell_anti-CD3-CD28_tx	/gpfs/hpc/projects/eQTLCatalogue/qtlmap/eQTL_Catalogue_r3/pipeline_out/sumstats/Schmiedel_2018.CD8_T-cell_anti-CD3-CD28_tx.nominal.sorted.tsv.gz	/gpfs/hpc/projects/eQTLCatalogue/qtlmap/eQTL_Catalogue_r3/pipeline_out/sumstats/Schmiedel_2018.CD8_T-cell_anti-CD3-CD28_tx.nominal.sorted.tsv.gz.tbi	/gpfs/hpc/projects/eQTLCatalogue/qtlmap/eQTL_Catalogue_r3/pipeline_out/sumstats/Schmiedel_2018.CD8_T-cell_anti-CD3-CD28_tx.permuted.txt.gz
Schmiedel_2018.CD8_T-cell_naive_tx	/gpfs/hpc/projects/eQTLCatalogue/qtlmap/eQTL_Catalogue_r3/pipeline_out/sumstats/Schmiedel_2018.CD8_T-cell_naive_tx.nominal.sorted.tsv.gz	/gpfs/hpc/projects/eQTLCatalogue/qtlmap/eQTL_Catalogue_r3/pipeline_out/sumstats/Schmiedel_2018.CD8_T-cell_naive_tx.nominal.sorted.tsv.gz.tbi	/gpfs/hpc/projects/eQTLCatalogue/qtlmap/eQTL_Catalogue_r3/pipeline_out/sumstats/Schmiedel_2018.CD8_T-cell_naive_tx.permuted.txt.gz
Schmiedel_2018.monocyte_CD16_naive_tx	/gpfs/hpc/projects/eQTLCatalogue/qtlmap/eQTL_Catalogue_r3/pipeline_out/sumstats/Schmiedel_2018.monocyte_CD16_naive_tx.nominal.sorted.tsv.gz	/gpfs/hpc/projects/eQTLCatalogue/qtlmap/eQTL_Catalogue_r3/pipeline_out/sumstats/Schmiedel_2018.monocyte_CD16_naive_tx.nominal.sorted.tsv.gz.tbi	/gpfs/hpc/projects/eQTLCatalogue/qtlmap/eQTL_Catalogue_r3/pipeline_out/sumstats/Schmiedel_2018.monocyte_CD16_naive_tx.permuted.txt.gz
Schmiedel_2018.monocyte_naive_tx	/gpfs/hpc/projects/eQTLCatalogue/qtlmap/eQTL_Catalogue_r3/pipeline_out/sumstats/Schmiedel_2018.monocyte_naive_tx.nominal.sorted.tsv.gz	/gpfs/hpc/projects/eQTLCatalogue/qtlmap/eQTL_Catalogue_r3/pipeline_out/sumstats/Schmiedel_2018.monocyte_naive_tx.nominal.sorted.tsv.gz.tbi	/gpfs/hpc/projects/eQTLCatalogue/qtlmap/eQTL_Catalogue_r3/pipeline_out/sumstats/Schmiedel_2018.monocyte_naive_tx.permuted.txt.gz
Schmiedel_2018.NK-cell_naive_tx	/gpfs/hpc/projects/eQTLCatalogue/qtlmap/eQTL_Catalogue_r3/pipeline_out/sumstats/Schmiedel_2018.NK-cell_naive_tx.nominal.sorted.tsv.gz	/gpfs/hpc/projects/eQTLCatalogue/qtlmap/eQTL_Catalogue_r3/pipeline_out/sumstats/Schmiedel_2018.NK-cell_naive_tx.nominal.sorted.tsv.gz.tbi	/gpfs/hpc/projects/eQTLCatalogue/qtlmap/eQTL_Catalogue_r3/pipeline_out/sumstats/Schmiedel_2018.NK-cell_naive_tx.permuted.txt.gz
Schmiedel_2018.Tfh_memory_tx	/gpfs/hpc/projects/eQTLCatalogue/qtlmap/eQTL_Catalogue_r3/pipeline_out/sumstats/Schmiedel_2018.Tfh_memory_tx.nominal.sorted.tsv.gz	/gpfs/hpc/projects/eQTLCatalogue/qtlmap/eQTL_Catalogue_r3/pipeline_out/sumstats/Schmiedel_2018.Tfh_memory_tx.nominal.sorted.tsv.gz.tbi	/gpfs/hpc/projects/eQTLCatalogue/qtlmap/eQTL_Catalogue_r3/pipeline_out/sumstats/Schmiedel_2018.Tfh_memory_tx.permuted.txt.gz
Schmiedel_2018.Th1_memory_tx	/gpfs/hpc/projects/eQTLCatalogue/qtlmap/eQTL_Catalogue_r3/pipeline_out/sumstats/Schmiedel_2018.Th1_memory_tx.nominal.sorted.tsv.gz	/gpfs/hpc/projects/eQTLCatalogue/qtlmap/eQTL_Catalogue_r3/pipeline_out/sumstats/Schmiedel_2018.Th1_memory_tx.nominal.sorted.tsv.gz.tbi	/gpfs/hpc/projects/eQTLCatalogue/qtlmap/eQTL_Catalogue_r3/pipeline_out/sumstats/Schmiedel_2018.Th1_memory_tx.permuted.txt.gz
Schmiedel_2018.Th1-17_memory_tx	/gpfs/hpc/projects/eQTLCatalogue/qtlmap/eQTL_Catalogue_r3/pipeline_out/sumstats/Schmiedel_2018.Th1-17_memory_tx.nominal.sorted.tsv.gz	/gpfs/hpc/projects/eQTLCatalogue/qtlmap/eQTL_Catalogue_r3/pipeline_out/sumstats/Schmiedel_2018.Th1-17_memory_tx.nominal.sorted.tsv.gz.tbi	/gpfs/hpc/projects/eQTLCatalogue/qtlmap/eQTL_Catalogue_r3/pipeline_out/sumstats/Schmiedel_2018.Th1-17_memory_tx.permuted.txt.gz
Schmiedel_2018.Th2_memory_tx	/gpfs/hpc/projects/eQTLCatalogue/qtlmap/eQTL_Catalogue_r3/pipeline_out/sumstats/Schmiedel_2018.Th2_memory_tx.nominal.sorted.tsv.gz	/gpfs/hpc/projects/eQTLCatalogue/qtlmap/eQTL_Catalogue_r3/pipeline_out/sumstats/Schmiedel_2018.Th2_memory_tx.nominal.sorted.tsv.gz.tbi	/gpfs/hpc/projects/eQTLCatalogue/qtlmap/eQTL_Catalogue_r3/pipeline_out/sumstats/Schmiedel_2018.Th2_memory_tx.permuted.txt.gz
Schmiedel_2018.Th17_memory_tx	/gpfs/hpc/projects/eQTLCatalogue/qtlmap/eQTL_Catalogue_r3/pipeline_out/sumstats/Schmiedel_2018.Th17_memory_tx.nominal.sorted.tsv.gz	/gpfs/hpc/projects/eQTLCatalogue/qtlmap/eQTL_Catalogue_r3/pipeline_out/sumstats/Schmiedel_2018.Th17_memory_tx.nominal.sorted.tsv.gz.tbi	/gpfs/hpc/projects/eQTLCatalogue/qtlmap/eQTL_Catalogue_r3/pipeline_out/sumstats/Schmiedel_2018.Th17_memory_tx.permuted.txt.gz
Schmiedel_2018.Treg_memory_tx	/gpfs/hpc/projects/eQTLCatalogue/qtlmap/eQTL_Catalogue_r3/pipeline_out/sumstats/Schmiedel_2018.Treg_memory_tx.nominal.sorted.tsv.gz	/gpfs/hpc/projects/eQTLCatalogue/qtlmap/eQTL_Catalogue_r3/pipeline_out/sumstats/Schmiedel_2018.Treg_memory_tx.nominal.sorted.tsv.gz.tbi	/gpfs/hpc/projects/eQTLCatalogue/qtlmap/eQTL_Catalogue_r3/pipeline_out/sumstats/Schmiedel_2018.Treg_memory_tx.permuted.txt.gz
Schmiedel_2018.Treg_naive_tx	/gpfs/hpc/projects/eQTLCatalogue/qtlmap/eQTL_Catalogue_r3/pipeline_out/sumstats/Schmiedel_2018.Treg_naive_tx.nominal.sorted.tsv.gz	/gpfs/hpc/projects/eQTLCatalogue/qtlmap/eQTL_Catalogue_r3/pipeline_out/sumstats/Schmiedel_2018.Treg_naive_tx.nominal.sorted.tsv.gz.tbi	/gpfs/hpc/projects/eQTLCatalogue/qtlmap/eQTL_Catalogue_r3/pipeline_out/sumstats/Schmiedel_2018.Treg_naive_tx.permuted.txt.gz
Schwartzentruber_2018.sensory_neuron_tx	/gpfs/hpc/projects/eQTLCatalogue/qtlmap/eQTL_Catalogue_r3/pipeline_out/sumstats/Schwartzentruber_2018.sensory_neuron_tx.nominal.sorted.tsv.gz	/gpfs/hpc/projects/eQTLCatalogue/qtlmap/eQTL_Catalogue_r3/pipeline_out/sumstats/Schwartzentruber_2018.sensory_neuron_tx.nominal.sorted.tsv.gz.tbi	/gpfs/hpc/projects/eQTLCatalogue/qtlmap/eQTL_Catalogue_r3/pipeline_out/sumstats/Schwartzentruber_2018.sensory_neuron_tx.permuted.txt.gz
TwinsUK.blood_tx	/gpfs/hpc/projects/eQTLCatalogue/qtlmap/eQTL_Catalogue_r3/pipeline_out/sumstats/TwinsUK.blood_tx.nominal.sorted.tsv.gz	/gpfs/hpc/projects/eQTLCatalogue/qtlmap/eQTL_Catalogue_r3/pipeline_out/sumstats/TwinsUK.blood_tx.nominal.sorted.tsv.gz.tbi	/gpfs/hpc/projects/eQTLCatalogue/qtlmap/eQTL_Catalogue_r3/pipeline_out/sumstats/TwinsUK.blood_tx.permuted.txt.gz
TwinsUK.fat_tx	/gpfs/hpc/projects/eQTLCatalogue/qtlmap/eQTL_Catalogue_r3/pipeline_out/sumstats/TwinsUK.fat_tx.nominal.sorted.tsv.gz	/gpfs/hpc/projects/eQTLCatalogue/qtlmap/eQTL_Catalogue_r3/pipeline_out/sumstats/TwinsUK.fat_tx.nominal.sorted.tsv.gz.tbi	/gpfs/hpc/projects/eQTLCatalogue/qtlmap/eQTL_Catalogue_r3/pipeline_out/sumstats/TwinsUK.fat_tx.permuted.txt.gz
TwinsUK.LCL_tx	/gpfs/hpc/projects/eQTLCatalogue/qtlmap/eQTL_Catalogue_r3/pipeline_out/sumstats/TwinsUK.LCL_tx.nominal.sorted.tsv.gz	/gpfs/hpc/projects/eQTLCatalogue/qtlmap/eQTL_Catalogue_r3/pipeline_out/sumstats/TwinsUK.LCL_tx.nominal.sorted.tsv.gz.tbi	/gpfs/hpc/projects/eQTLCatalogue/qtlmap/eQTL_Catalogue_r3/pipeline_out/sumstats/TwinsUK.LCL_tx.permuted.txt.gz
TwinsUK.skin_tx	/gpfs/hpc/projects/eQTLCatalogue/qtlmap/eQTL_Catalogue_r3/pipeline_out/sumstats/TwinsUK.skin_tx.nominal.sorted.tsv.gz	/gpfs/hpc/projects/eQTLCatalogue/qtlmap/eQTL_Catalogue_r3/pipeline_out/sumstats/TwinsUK.skin_tx.nominal.sorted.tsv.gz.tbi	/gpfs/hpc/projects/eQTLCatalogue/qtlmap/eQTL_Catalogue_r3/pipeline_out/sumstats/TwinsUK.skin_tx.permuted.txt.gz
van_de_Bunt_2015.pancreatic_islet_tx	/gpfs/hpc/projects/eQTLCatalogue/qtlmap/eQTL_Catalogue_r3/pipeline_out/sumstats/van_de_Bunt_2015.pancreatic_islet_tx.nominal.sorted.tsv.gz	/gpfs/hpc/projects/eQTLCatalogue/qtlmap/eQTL_Catalogue_r3/pipeline_out/sumstats/van_de_Bunt_2015.pancreatic_islet_tx.nominal.sorted.tsv.gz.tbi	/gpfs/hpc/projects/eQTLCatalogue/qtlmap/eQTL_Catalogue_r3/pipeline_out/sumstats/van_de_Bunt_2015.pancreatic_islet_tx.permuted.txt.gz
